11111111111111111111
19002222222222222091
10112111221121121101
10012222221122121001
12112111221121121101
12222222222222222221
12112211221211211221
12112221221222222221
12111121111211111221
12222222222222222221
12122221122122211221
12112222122122111101
10101211122122101101
19000222222222000091
11111111111111111111
