11111111111111111111
19000000000000000091
10110111001101101101
10010000001100101001
10110111001101101101
10000000000000000001
10110011001011011001
10110001001000000001
10111101111011111001
10000000000000000001
10100001100100011001
10110000100100111101
10101011100100101101
19000000000000000091
11111111111111111111
