11111111111111111111
19000000000000000091
10000000000000000001
10000000000000000001
10000010000000000001
10000000000000000001
10000000000000000001
10000000000000000001
10000000001000000001
10000000000000000001
10000000000000000001
10000000000000000001
10000000000000000001
19000000000000000091
11111111111111111111
